4 4 4 4 4 4 4 4 4 4 4 4 4 4 4 4 4
 4 5 5 5 5 5 5 5 4 5 5 5 5 5 5 5 4
 4 5 4 4 5 4 4 5 4 5 4 4 5 4 4 5 4
 4 6 5 5 5 5 5 5 5 5 5 5 5 5 5 6 4
 4 5 4 4 5 4 5 4 4 4 5 4 5 4 4 5 4
 4 5 5 5 5 4 5 5 4 5 5 4 5 5 5 5 4
 4 4 4 4 5 4 4 15 4 15 4 4 5 4 4 4 4
 15 15 15 4 5 4 15 15 14 15 15 4 5 4 15 15 15
 4 4 4 4 5 4 15 4 15 4 15 4 5 4 4 4 4
 7 15 15 15 5 15 15 4 10 4 15 15 5 15 15 15 8
 4 4 4 4 5 4 15 4 4 4 15 4 5 4 4 4 4
 15 15 15 4 5 4 15 15 0 15 15 4 5 4 15 15 15
 4 4 4 4 5 4 15 4 4 4 15 4 5 4 4 4 4
 4 5 5 5 5 5 5 5 4 5 5 5 5 5 5 5 4
 4 5 4 4 5 4 4 5 4 5 4 4 5 4 4 5 4
 4 6 5 4 5 5 5 5 5 5 5 5 5 4 5 6 4
 4 4 5 4 5 4 4 4 5 4 4 4 5 4 5 4 4
 4 5 5 5 5 5 5 5 5 5 5 5 5 5 5 5 4
 4 4 4 4 4 4 4 4 4 4 4 4 4 4 4 4 4;
4 4 4 4 4 4 4 4 4 4 4 4 4 4 4 4 4
 4 4 4 4 4 4 4 4 4 4 4 4 4 4 4 4 4
 4 4 4 4 4 4 4 4 4 4 4 4 4 4 4 4 4
 4 6 5 5 5 5 5 5 5 5 5 5 5 5 5 6 4
 4 5 4 4 5 4 5 4 4 4 5 4 5 4 4 5 4
 4 5 5 5 5 4 5 5 4 5 5 4 5 5 5 5 4
 4 4 4 4 5 4 4 15 4 15 4 4 5 4 4 4 4
 15 15 15 4 5 4 15 15 14 15 15 4 5 4 15 15 15
 4 4 4 4 5 4 15 4 15 4 15 4 5 4 4 4 4
 7 15 15 15 5 15 15 4 10 4 15 15 5 15 15 15 8
 4 4 4 4 5 4 15 4 4 4 15 4 5 4 4 4 4
 15 15 15 4 5 4 15 15 0 15 15 4 5 4 15 15 15
 4 4 4 4 5 4 15 4 4 4 15 4 5 4 4 4 4
 4 5 5 5 5 5 5 5 4 5 5 5 5 5 5 5 4
 4 5 4 4 5 4 4 5 4 5 4 4 5 4 4 5 4
 4 6 5 4 5 5 5 5 5 5 5 5 5 4 5 6 4
 4 4 4 4 4 4 4 4 4 4 4 4 4 4 4 4 4
 4 4 4 4 4 4 4 4 4 4 4 4 4 4 4 4 4
 4 4 4 4 4 4 4 4 4 4 4 4 4 4 4 4 4;
